&&&&&&&&&&&&
&          &
&          &
&          &
&          &
&          &
&          &
&          &
&          &
&          &
&          &
&          &
&          &
&          &
&          &
&          &
&          &
&          &
&    O     &
&          &
&    O     &
&&&&&&&&&&&&