&&&&&&&&&&&&
&          &
&          &
&          &
&          &
&          &
&          &
&          &
&          &
&          &
&          &
&          &
&          &
&          &
& O      O &
&          &
&  OO  OO  &
&  OO  OO  &
&    OO    &
&   O  O   &
&  O    O  &
&&&&&&&&&&&&