&&&&&&&&&&&&
&          &
&          &
&          &
&          &
&          &
&          &
&          &
&          &
&          &
&          &
&          &
&          &
&          &
&          &
&          &
&   O  O   &
&   O  O   &
&    OO    &
&    OO    &
&    OO    &
&&&&&&&&&&&&