&0123456789&
&          &
&          &
&          &
&          &
&          &
&          &
&          &
&          &
&   345    &
&   3 5    &
&  23456   &
&    4     &
&          &
&          &
&          &
&          &
&          &
&          &
&          &
&          &
&0123456789&