
&0123456789&
&          &
&          &
&          &
&          &
&          &
&          &
&          &
&          &
&   3      &
&   34     &
& 1 34567  &
&       7  &
& 1 34567  &
&   34     &
&   3      &
&          &
&          &
&          &
&          &
&          &
&0123456789&