
&&&&&&&&&&&&
&          &
&          &
&          &
&          &
&          &
&          &
&          &
&          &
&          &
&    OO    &
&   O  O   &
&  O    O  &
& O      O &
&          &
& OOO  OOO &
&   O  O   &
&    OO    &
&   O  O   &
&   O  O   &
& OOOOOOOO &
&&&&&&&&&&&&