&&&&&&&&&&&&
&          &
&          &
&          &
&          &
&          &
&          &
&          &
&          &
&          &
&          &
&          &
&          &
&          &
&  OO  OO  &
& O  OO  O &
& O      O &
&  O    O  &
&   O  O   &
&    OO    &
&          &
&&&&&&&&&&&&



