
&&&&&&&&&&&&
&          &
&          &
& O OOOO O &
&  O    O  &
&          &
&  OO  OO  &
& O  OO  O &
&          &
& O O  O O &
& OOOOOOOO &
&          &
&          &
&          &
&          &
&          &
&          &
&          &
&          &
&          &
&          &
&&&&&&&&&&&&