&&&&&&&&&&&&
&          &
&          &
&          &
&          &
&          &
&          &
&          &
&          &
&          &
&          &
&    4     &
&          &
&          &
&          &
&    4     &
&0 2   6 8 &
&  2   6   &
&    4     &
&    4     &
& 1234567  &
&&&&&&&&&&&&