&&&&&&&&&&&&
&          &
&          &
&          &
&          &
&          &
&          &
&          &
&          &
&          &
&  O OO O  &
&          &
&          &
&          &
&    OO    &
&          &
&          &
&    OO    &
&    OO    &
&          &
&          &
&&&&&&&&&&&&