
&&&&&&&&&&&&
&          &
&     $    &
&          &
&          &
&  OOOOOO  &
&          &
&          &
&          &
&   OOOO   &
&          &
&          &
&    OO    &
&          &
&  OOOOOO  &
&          &
&          &
&          &
&          &
&          &
&          &
&&&&&&&&&&&&