&&&&&&&&&&&&
&          &
&          &
&          &
&          &
&          &
&          &
&          &
&          &
&          &
&          &
&          &
&          &
&          &
&          &
&          &
&          &
&          &
&    OO    &
&   OOOO   &
&  OOOOOO  &
&&&&&&&&&&&&